#
# 0 D room0.txt 1 key1
# 1 D room0.txt 0
#
# k key1
#
WWWWWWWWWW
WS       W
W        W
W  m   k W
W        W
W      W W
W      WhW
W  WWWWW W
0  W     W
WWWW1WWWWW